wwwwwwwwwwwwwwwwwwwwwwwwwwwwwwww
w              w               w
w              w               w
w           w  w  w            w
w            wwwww             w
w                              w
w                              w
w                              w
w                              w
w                              w
w                              w
w                              w
w                              w
w                              w
w                              w
w  s                     e   n w
w          a                   w
wwwwwwwwwwwwwwwwwwwwwwwwwwwwwwww
