wwwwwwwwwwwwwwwwwwwwwwwwwwwwwwww
w                              w
w                              w
w                              w
w                              w
w                              w
w                              w
w                              w
w                              w
w                              w
w                              w
w                              w
w                              w
w                              w
w                              w
w     s                        w
wnn        a          n      e w
wwwwwwwwwwwwwwwwwwwwwwwwwwwwwwww
