wwwwwwwwwwwwwwwwwwwwwwwwwwwwwwww
w  w w w w w w ww w w w w w w  w
w                              w
w                              w
w                              w
w                              w
w                              w
w                              w
w                              w
w                              w
w                              w
w                              w
w                              w
w                              w
w                              w
w s                            w
w     a   a    n    n        wew
wwwwwwwwwwwwwwwwwwwwwwwwwwwwwwww
