wwwwwwwwwwwwwwwwwwwwwwwwwwwwwwww
w                              w
w                              w
w                              w
w                              w
w                              w
w                              w
w                              w
w                              w
w                              w
w                              w
w                              w
w                              w
w                              w
w                              w
w  s                           w
w       a a a      n  n   e  n w
wwwwwwwwwwwwwwwwwwwwwwwwwwwwwwww
