wwwwwwwwwwwwwwwwwwwwwwwwwwwwwwww
w              w               w
w              w               w
w           w  w  w            w
w            wwwww             w
w                              w
w                              w
w                              w
w                              w
w                              w
w                              w
w                              w
w                              w
w                              w
w                              w
w  s                           w
w          a             n  e  w
wwwwwwwwwwwwwwwwwwwwwwwwwwwwwwww
