wwwwwwwwwwwwwwwwwwwwwwwwwwwwwwww
w                              w
w                              w
w                              w
w                              w
w                              w
w                              w
w                              w
w                              w
w                              w
w                              w
w                              w
w                              w
w                              w
w                              w
w  s                           w
w          a             e   n w
wwwwwwwwwwwwwwwwwwwwwwwwwwwwwwww
