w                              w
w                              w
w                              w
w                              w
w                              w
w                              w
w                              w
w                              w
w                              w
w                              w
w                              w
w                              w
w                              w
w                              w
w                              w
w s                            w
w                             ew
wwwwwwwwwwwwwwwwwwwwwwwwwwwwwwww
