w                              w
w                              w
w                              w
w                              w
w                              w
w                              w
w                              w
w                              w
w                              w
w                              w
w                              w
w                              w
w                              w
w                              w
w                              w
w        s                     w
w n n            n n n n  e  n w
wwwwwwwwwwwwwwwwwwwwwwwwwwwwwwww
