w                              w
w                              w
w                              w
w                              w
w                              w
w                              w
w                              w
w                              w
w                              w
w                              w
w                              w
w                              w
w                              w
w                              w
w                              w
w  s                     e   n w
w          a                   w
wwwwwwwwwwwwwwwwwwwwwwwwwwwwwwww
