w                              w
w                              w
w                              w
w                              w
w                              w
w                              w
w                              w
w                              w
w                              w
w                              w
w                              w
w                     w        w
w                     t        w
w                              w
w                              w
w s            w     n         w
w   aaaaaaaaawww             wew
wwwwwwwwwwwwwwwwwwwwwwwwwwwwwwww
