wwwwwwwwwwwwwwwwwwwwwwwwwwwwwwww
w                              w
w                              w
w                              w
w                              w
w                              w
w                              w
w                              w
w                              w
w                              w
w                              w
w                              w
w                              w
w                              w
w                             nw
w  s                         www
w          a           n    wwww
wwwwwwwwwwwwwwwwwwwwwwwwwwwwwwww
