w                              w
w                              w
w                              w
w                              w
w                              w
w                              w
w                              w
w                              w
w                              w
w                              w
w                              w
w                              w
w                              w
w                              w
w          e      w            w
w  s             ww          n w
w          a    www            w
wwwwwwwwwwwwwwwwwwwwwwwwwwwwwwww
