wwwwwwwwwwwwwwwwwwwwwwwwwwwwwwww
w                              w
w                              w
w                              w
w                              w
w                              w
w                              w
w                              w
w                              w
w                              w
w                              w
w                              w
w                              w
w                              w
w                             ew
w  s                         www
w          a           n    wwww
wwwwwwwwwwwwwwwwwwwwwwwwwwwwwwww
